14 34
##################################
#                   ^            *
#    ^    ###################### *
#         #                      *
#         #                      *
### #######                      *
#             * *  *  ** * * * * *
#                                *
#       $############D############
#        #    F                  #
#        #             ###### ####
#$       #             #         #
#        #                 ^     #
#*       *     %       #         #